   F      000,112,112
C 0,255,5





NO     ./assets/textures/dir_north.xpm
SO  ./assets/textures/dir_south.xpm
WE            ./assets/../assets/textures/dir_west.xpm
EA ./assets/textures/dir_east.xpm






111111111111111111111111
1000000000110000000000011
10110000011100000000000  1
1001W 0000000000000000011
101100000111000000000001
100000000011000001110111
111101111111111111000001
111101111010101011010101
110000001101010111000001
100000000000000011000001
100000000000000011010101
110000001101010111110111
111101111111011111110111
111101111111001011000001
110000011100000011000001
100000001100000011000001
100000001111111011100011
100000001111111110010101
110000011100011010100011
100000001000001101010101
100000000000000000000001
100000001000001101011101
110000011100011010100011
111111111111111111111 11